1111111111111
1001000CE0001
10P0011111001
100010C000C01
1111111111111