111111111111111111111111111111111111111111
10000P0000010000010000000C1C000000000010C1
100000000001000101000011111110011C10111001
100000111111111100100100000011111010000001
101111000000000100010000001111010001111101
100C000001101C1001001000000000010010011101
111100011111000010001001000011100100000001
101C00101010001001001001111111001000000001
1000100C10100000100001C0000010011000000001
101100100100010001011000000100101000000001
10001001E00100C010000100011001000111100011
100C100011100001C00000101CCC1000000C001001
100C10000000000010000000001110000000110C01
111111111111111111111111111111111111111111