1111111111111111111111111111111111111111111111111
10000P0000000010000000010000000C1C0000000000010C1
100000000000001000000101000011111110011C111111001
1000001111111111000001001000000111110101000000001
1011110000000000000001000100000011110100011111101
100C000000000001101C11010010000000000100100011101
1111000111110000000100010010000000111001000000001
101C000100010100011000010010011111110010000000001
1000100C10100010101000001C00000000100110000000001
1011000001000001000100010110000001001001000000001
10001000001E00100000C0100001000110010000111100011
100C100000011100000001C00000101CCC10000000C001001
100C100000000000000000100000000011100000000110C01
1111111111111111111111111111111111111111111111111