1111111111111
1001000C00011
1000011111001
1P0011E000001
1111110111111